# This puzzle is solvable
15
  1 104  40   2  60  35 170 191 161  10  66  11  69  30 126 
 55  56 102   3   5  46  88   8 152  12 113  68 163  17  26 
  4 100 200  52  89  37 182  63   9 184 112 115  13  83 208 
142 108 143  38  61   7 150 109 219 148  64 157  73  15  14 
 57  58  59 211 146 204  62 213  74 117 114 153  19 116  22 
 51 106 107 101 145 110 111 202 151  16  72 149  67  65  18 
 53  99 147 105 185  97 180   6  70 181 119 154  71  21  23 
131 144 136 223 141 205 203  78 209 155 216 178  39 122 158 
171 138 103  54  42 199 166 220 179 137 164 206 118   0  20 
 93  49 176  90 217 224 222 165 214 125 218 201 183  76  77 
167 140  45 175 135  44 156 132  86 128  82 187 120  81  80 
169 133 130 134  41 177  95 160 193 173 174 159  75  85 188 
194 210  98 212 172 215  36  87 207  34  29 129  84 162 189 
196  43 198  47  91 124 168 123 190 186 121 195  24  79  27 
 50  48  94  96 197 139  31 192 221  32  28  92 127  33  25 

