# This puzzle is solvable
65
   1    2    3    4    5    6    7    8    9   10  435   11   13   14   15   16   17   18   19   20   21   22   23   24   25   26   27   28   29   30   31   32   33   34   36   37  157  292   39   40   41   42   43   44   45   46   47   48   49   50   51   52   53   54   55   56   57   58   59  134   61   62   63   64   65 
 256  257  258  259  260  261  262  263  265  266  267   12  268  269  270  271  272  273  274  275  276  277  278  279  280  281  282  283  284  285  286  287  288  289   35  291  293   38  294  295  296  297  298  299  300  301  302  303  304  305  306  307  308  309  311  312  558  313  314   60  315  317  318  319   66 
 255  504  505  506  507  508  509  510  264  512  513  514  515  516  517  518  519  520  521  522  523  524  525  526  527  528  529  530  531  532  533  534  535  536  290  538  539  540  541  542  543  544  545  546  547  548  549  550  551  552  553  554  555  556  557  559  798  560  562  563  316  564  565  320   67 
 254  503  744  745  746  747  748  749  511  750  752  753  754  755  756  757  758  759  760  761  762  763  764  765  766  767  768  769  771  772  773  774  775  776  537  777  778  779  780  781  782  783  784  785  786  787  788  789  790  791  792  793  794 1027  310 1028 1029  800  561  801  802  803  566  321   68 
 501  743  742  976  977  979 1202  980  982  751  983  984  985  986  987  988  989  990  991  992  993  994  995  996  997  998  999 1223 1000  770 1003 1004 1228 1005 1007 1008 1009 1010 1011 1012 1013 1014 1015 1016 1017 1018 1019 1020 1021 1022 1023 1024 1026  797  795  796 1030  799 1031 1032 1033  804  567  322   69 
 502  253  975  974 1200  978 1203 1204  981 1205 1206 1207 1208 1209 1210 1211 1212 1213 1214 1215 1216 1217 1218 1219 1220 1221 1222 1224 1001 1440 1002 1443 1230 1445 1006 1231 1232 1233 1234 1235 1236 1237 1238 1239 1240 1241 1242 1243 1244 1245 1246 1247 1025 1248 1249 1251 1252 1255 1254 1034 1256  805  568   71  323 
 252  249  741  973 1199 1201 1417 1418 1419 1420 1421 1422 1423 1424 1425 1426 1427 1428 1429 1430 1431 1432 1433 1434 1435 1436 1437 1438 1439 1648 1227 1225 1444 1229 1652 1446 1447 1448 1449 1450 1451 1452 1453 1454 1455 1456 1457 1458 1459 1460 1461 1462 1463 1464 1250 1673 1466 1468 1253 1257 1469  806  570  569   70 
 500  251  740  499 1198 1416 1624 1625 1626 1627 1628 1629 1630 1631 1632 1633 1634 1635 1636 1637 1638 1639 1640 1641 1642 1643 1644 1645 1646 1846 1226 1442 1650 1651 1853 1851 1653 1654 1656 1657 1658 1659 1660 1661 1662 1663 1664 1665 1666 1667 1668 1669 1670 1671 1465 1871 1467 1674 1675 1470 1035 1036  807  324   72 
 496  247  971  739 1414 1415 1623 1824 1825 1826 1827 1828 1829 1830 1831 1832 1833 1834 1835 1836 1837 1838 1839 1840 1841 1842 2034 1844 1845 1649 1847 1441 1647 1849 1850 2042 1854 1655 1855 1856 1857 1858 1859 1860 1861 1862 1863 1864 1865 1866 1868 2060 1869 1870 1872 1672 1873 1676 1471 1258 1037  808  571  325  326 
 250  498  972  970 1197 1413 1621 1823 2016 2017 2018 2019 2020 2021 2022 2023 2024 2025 2026 2027 2028 2029 2030 2031 2032 2033 2035 1843 2036 2037 2038 1848 2039 2040 2041 1852 2043 2045 2046 2047 2048 2049 2050 2051 2052 2053 2054 2055 2056 2057 1867 2058 2059 2061 2062 2063 1874 1677 1472 1259 1038  809  572  327   73 
 248  738  737 1195 1196 1622 1412 1822 2015 2200 2201 2202 2203 2204 2205 2206 2207 2208 2209 2210 2211 2212 2213 2214 2215 2216 2217 2218 2219 2220 2221 2222 2223 2224 2225 2226 2044 2227 2228 2230 2231 2232 2233 2234 2235 2236 2237 2238 2239 2240 2241 2242 2243 2244 2245 2064 1875 1678 1473 1260  810  573  328   75   74 
 497  245  495  968 1194 1411 1620 1821 2014 2199 2376 2377 2378 2379 2380 2381 2382 2383 2384 2385 2386 2387 2388 2389 2390 2391 2392 2393 2394 2395 2396 2397 2398 2399 2400 2401 2402 2404 2229 2405 2406 2407 2408 2409 2410 2411 2412 2413 2414 2415 2416 2417 2418 2419 2246 2065 1876 1679 1474 1261 1039  812  574  329   76 
 494  246  736  734  969 1410 1619 1820 2013 2197 2198 2544 2545 2546 2547 2548 2549 2550 2551 2552 2553 2554 2555 2556 2557 2558 2559 2560 2561 2562 2563 2564 2565 2566 2567 2568 2569 2403 2570 2572 2573 2574 2575 2576 2577 2578 2579 2580 2581 2582 2583 2584 2585 2420 2247 2066 1877 1680 1476 1041  811 1040  575  331   77 
 244  493  735  966 1193 1192 1618 1819 2012 2196 2375 2543 2703 2704 2705 2707 2708 2709 2710 2711 2712 2713 2714 2715 2716 2717 2718 2719 2720 2721 2722 2723 2724 2725 2726 2727 2728 2729 2571 2731 2732 2733 2734 2735 2736 2737 2738 2739 2740 2741 2742 2743 2586 2421 2248 2067 1878 1681 1262 1475 1042  813  330  576   78 
 243  492  733 1190  967 1409 1407 1816 1818 2195 2374 2541 2542 2856 2706 2858 2859 3003 2860 2861 2863 2864 2865 2866 2867 2868 2869 2870 2871 2872 2873 2874 2875 2876 2877 2878 2879 3024 2730 2882 2883 2884 2885 2886 2887 2888 2889 2890 2891 2892 2893 2744 2587 2422 2249 2068 1879 1682 1477 1263 1043  814  577  332   79 
 242  489  491 1191 1408 1614 1617 1817 2011 2010 2373 2540 2702 2855 2857 3000 3265 3138 3002 2862 3006 3007 3008 3009 3010 3011 3012 3013 3014 3015 3016 3017 3018 3019 3020 3021 3022 2881 2880 3025 3026 3027 3028 3029 3030 3031 3032 3033 3034 3035 2894 2745 2588 2423 2250 2069 1880 1683 1478 1264  579  578 1045  333   80 
 490  732  731 1188 1189 1187 1815 1616 2009 2371 2372 2539 2854 2999 2998 3001 3137 3139 3004 3005 3141 3142 3143 3144 3145 3146 3147 3148 3149 3150 3151 3152 3153 3155 3156 3157 3284 3023 3159 3160 3161 3162 3163 3164 3165 3166 3167 3168 3169 3036 2895 2746 2589 2424 2251 2070 1881 1684 1266 1265 1044  816  815  334   81 
 241  730  965  964  963 1405 1615 1613 2193 2194 2192 2370 2538 2853 2996 3136 3135 3266 3140 3267 3268 3269 3270 3271 3272 3273 3274 3275 3277 3278 3279 3398 3280 3154 3282 3283 3404 3158 3405 3287 3288 3289 3290 3291 3292 3293 3294 3295 3170 3037 2896 2747 2590 2425 2252 2071 1882 1685 1479 1480 1046  818  817  335   82 
 240  488  729  962 1404 1406 1814 2007 2008 2368 2537 2369 2701 2700 2997 3134 3263 3264 3384 3385 3387 3388 3389 3390 3391 3392 3393 3395 3276 3396 3397 3399 3400 3281 3401 3402 3285 3286 3403 3406 3407 3408 3409 3410 3411 3412 3413 3296 3171 3038 2897 2748 2591 2426 2253 2072 1883 1686 1481 1267 1268 1047  580  581   83 
 239  487  728  961 1186 1403 1612 1813 2005 2006 2191 2697 2851 2850 2852 3133 3261 3383 3497 3600 3498 3499 3500 3501 3502 3503 3504 3394 3506 3507 3508 3509 3510 3511 3512 3513 3514 3515 3516 3517 3518 3519 3520 3521 3522 3523 3414 3297 3172 3039 2898 2749 2592 2427 2254 2073 1884 1687 1482 1269 1048  819  582  336  337 
 238  486  727  960 1185 1402 1611 1812 2004 2190 2536 2698 2699 2849 2995 3262 3132 3495 3386 3496 3601 3602 3603 3604 3605 3607 3702 3505 3609 3610 3611 3612 3613 3614 3615 3616 3617 3618 3619 3620 3621 3622 3623 3624 3625 3524 3415 3298 3173 3040 2899 2750 2593 2428 2255 2074 1885 1688 1483 1270 1049  820  338   85   84 
 237  236  726  959 1184 1401 1610 1811 2189 2366 2535 2365 2696 2848 2994 3131 3260 3493 3494 3599 3696 3697 3698 3699 3700 3606 3703 3608 3704 3705 3706 3707 3708 3709 3710 3711 3712 3713 3714 3715 3716 3717 3718 3719 3626 3525 3416 3299 3174 3041 2900 2751 2594 2429 2256 2075 1886 1689 1484 1271 1050  821  583  584  586 
 484  485  957  725 1183 1400 1609 1810 2003 2188 2367 2534 2695 2847 2993 3130 3379 3382 3259 3598 3695 3784 3785 3786 3787 3701 3789 3790 3791 3792 3793 3794 3795 3796 3797 3798 3799 3800 3801 3802 3803 3804 3805 3720 3627 3526 3417 3300 3175 3042 2901 2752 2595 2430 2257 2076 1691 1887 1486 1272  823 1052  822   86   88 
 235  723  483  958 1182 1399 1608 1809 2002 2187 2532 2364 2693 2846 3127 2694 3380 3376 3381 3492 3597 3864 3865 3866 3867 3788 3868 3869 3870 3871 3872 3873 3874 3875 3876 3877 3878 3879 3880 3881 3882 3883 3806 3721 3628 3527 3418 3301 3176 3043 2902 2753 2596 2431 2258 2077 1485 1690 1273 1274 1053 1051  585   87  339 
 234  724  722  956 1181 1398 1607 1808 2001 2186 2363 2533 2844 3129 3128 3258 3256 3489 3491 3596 3783 3782 3863 3936 3937 3938 3939 3940 3941 3942 3943 3944 3945 3946 3947 3948 3949 3950 3951 3952 3953 3884 3807 3722 3629 3528 3419 3302 3177 3044 2903 2754 2597 2432 2260 2259 1888 1890 1487 1692  825  587  340  341  342 
 482  232  721  954  955 1397 1606 2000 1999 2185 2530 2692 2691 2992 2990 2991 3378 3595 3692 3693 3694 3781 3862 3935 4000 4001 4002 4003 4004 4005 4006 4007 4008 4009 4065 4010 4011 4012 4013 3954 3955 3885 3808 3723 3630 3529 3420 3303 3178 3045 2904 2755 2598 2433 2078 1891 1892 2079 1889 1693  588  824  343  344   89 
 233  480  481  720 1180 1396 1804 1605 2182 2361 2183 2531 2845 2843 3126 3255 3377 3488 3490 3594 3593 3780 3861 3934 3999 4056 4057 4058 4059 4060 4061 4062 4063 4064 4113 4112 4067 4068 4014 4015 3886 3810 3809 3724 3631 3530 3421 3304 3179 3046 2906 2905 2599 2434 2080 1694 1893 1489 1054  590  827  589 1276  826   90 
 230  231  953 1176 1179 1395 1393 1604 1807 2184 2362 2360 2690 2988 3124 3257 3125 3254 3592 3689 3779 3860 3778 3933 3997 3998 4103 4104 4105 4107 4108 4109 4110 4111 4066 4152 4114 4115 4070 4069 4017 3811 3725 3726 3632 3531 3422 3305 3181 3180 3047 2756 2600 2435 2261 2081 1696 1695 1275 1055 1277 1056  345   92   91 
 479  718  719 1178  952 1603 1998 1806 1805 2181 2359 2529 2689 2841 2989 2987 3374 3486 3375 3691 3487 3690 3996 3858 3931 4055 4054 4145 4106 4146 4147 4148 4149 4150 4151 4183 4116 4154 3957 4016 4018 3887 3889 3633 3635 3533 3532 3423 3306 2907 2758 2757 2601 2436 2262 2082 2263 1491 1490 1488 1278  828  347  346   93 
 228  476  478 1175 1394  717 1177 1996 1997 2180 2358 2528 2687 2688 2842 3123 3253 3252 3373 3591 3687 3688 3857 3859 3932 4053 4102 4144 4176 4177 4178 4179 4180 4204 4181 4118 4182 4153 4071 4019 3956 4072 3888 3727 3728 3634 3424 3307 3049 3048 2908 2759 2602 2437 2264 2084 1895 1493 1894 1279 1280 1057  591  829   94 
 227  951  477 1174  948 1602 1803 1392 1601 1995 2357 2527 2526 2840 2986 2985 3251 3372 3588 3484 3485 3590 3777 3776 4052 4101 4051 4143 4175 4200 4201 4202 4203 4205 4184 4155 4185 4073 4117 4020 3959 3958 3891 3813 3729 3534 3425 3308 3182 3050 2909 2760 2603 2438 2265 1896 1492 2083 1281 1058  830  593  592  348   95 
 475  229  947  949 1390 1172 1600 1391 1802 2179 2356 2525 2686 2839 2984 3122 3250 3370 3371 3482 3589 3775 3856 3993 3995 4100 3994 4142 4174 4199 4216 4217 4218 4219 4156 4206 4157 4119 4074 4021 3960 3814 3812 3890 3535 3309 3310 3185 3183 3051 2910 2761 2604 2439 2085 1699 1698 1697 1496 1494 1059  831  594  349   96 
 715  950  716 1173 1171 1599 1801 1994 1993 2178 2355 2524 2685 2838 2983 3121 3247 3367 3369 3686 3483 3930 3992 3929 4050 4099 4138 4141 4140 4139 4215 4224 4222 4220 4207 4186 4158 4121 4120 4022 3961 3815 3730 3731 3636 3536 3426 3184 3186 3052 2911 2762 2440 2267 2266 2086 1897 1700 1283 1061 1060  832  595  350   97 
 225  226  474  713 1389 1598 1800 1799 1992 2177 2354 2523 2684 2837 2982 3249 3120 3248 3368 3684 3683 3774 3854 3772 3991 3928 4049 4137 4198 4173 4214 4223 4221 4210 4209 4208 4160 4075 4077 3894 4023 3892 3637 3816 3638 3428 3429 3427 3311 3053 2912 2606 2605 2441 2268 2087 1898 1495 1701 1282 1062  833  596  351   98 
 224  473  712  946 1170 1388 1597 1798 1991 2176 2353 2522 2683 2836 3118 3119 3583 3481 3770 3587 3685 3480 3771 3852 3990 4098 4170 4136 4197 4171 4194 4195 4213 4212 4188 4189 4159 4187 4024 3962 3964 3893 3895 3817 3639 3537 3312 3313 3187 3054 2763 2766 2607 2442 2269 2088 1899 1702 1497 1284 1063  834  597  352   99 
 220  223  472  714  945 1387 1596 1797 1990 2175 2352 2521 2682 2980 2981 3117 3246 3681 3773 3586 3927 3855 3853 3926 3925 4048 4094 4169 4196 4172 4193 4166 4192 4211 4190 4162 4161 4122 4123 4078 3963 3733 3732 3640 3539 3541 3430 3188 3056 3055 2913 2608 2609 2443 2270 2089 1900 1703 1498 1285 1064  835  598  353  100 
 222  221  709  469  711 1169 1595 1796 1989 2174 2351 2519 2520 2835 2833 3478 3244 3364 3479 3678 3682 3585 3921 3986 3989 4046 4097 4047 3850 4040 4134 4168 4165 4191 4163 4127 4076 4124 4026 4025 3965 3819 3818 3734 3538 3316 3314 3432 3317 2915 3189 3190 2764 2444 2271 2090 1901 1704 1499 1286 1065  836  599  354  101 
 470  471  943  710  944 1168 1594 1795 1988 2173 2350 2172 2978 3115 2979 3245 3116 3365 3584 3680 3768 4044 3924 3849 3769 3923 4095 4096 4135 4091 4167 4133 4131 4164 4128 4084 4126 4080 4079 4027 3966 3896 3820 3642 3641 3542 3431 3191 3057 2916 2768 2610 2765 2445 2272 2091 1902 1705 1500 1287 1066  837  600  355  102 
 218  219  708  707 1167 1386 1384 1793 1794 2171 2349 2834 2976 2680 2832 2977 3114 3242 3366 3582 3581 3851 3767 3847 4093 3922 3987 3988 4041 4092 4038 4088 4087 4129 4130 4085 4125 4032 4082 4028 3967 3897 3822 3735 3736 3643 3315 3192 3540 2767 2914 2611 2612 2446 2273 2092 1903 1706 1501 1288 1067  838  601  356  103 
 468  467  941  942 1166 1385 1593 1592 1987 2170 2348 2830 2518 2678 3243 2975 3362 3363 3477 3677 3580 3679 3848 3845 3985 4045 4043 4042 4090 4089 3980 4037 3977 4086 4034 3974 4031 4083 4081 4030 3899 3823 3644 3821 3543 3645 3435 3433 3059 3058 2769 2917 2918 2447 2274 2093 1904 1707 1502 1289 1068  839  602  357  104 
 216  464  217  940 1165 1383 1591 1792 1986 1985 2347 2679 2517 2681 2829 3113 3112 3241 3111 3476 3766 3676 3846 3920 3919 3984 3982 4132 4039 3913 3981 4036 4035 3979 3975 3973 4033 3972 3971 3968 4029 3898 3738 3737 3646 3434 3436 3318 3193 3060 2919 2770 2448 2449 2275 2094 1905 1708 1503 1290 1069  840  603  358  105 
 465  705  466  939 1164 1382 1590 1791 1984 2168 2515 2516 2831 2677 2828 3110 2974 3578 3361 3475 3474 3579 3765 3764 3842 3916 3983 3915 3838 3839 3912 3978 3910 3832 3976 3907 3906 3905 3904 3902 3969 3824 3900 3901 3739 3545 3544 3319 3194 3061 2771 2614 2613 2450 2276 2095 1906 1709 1504 1291 1070  841  604  359  106 
 215  706  938 1163 1380 1381 1379 1790 2344 2167 2169 2513 2514 2827 2825 2675 3240 3360 3472 3473 3675 3672 3844 3762 3760 3843 3758 3840 3914 3755 3837 3834 3909 3908 3833 3831 3748 3830 3829 3970 3903 3827 3825 3740 3647 3437 3320 3195 3062 3063 2920 2615 2616 2451 2277 2096 1907 1710 1505 1292 1071  842  605  360  107 
 214  463  704  937 1161 1162 1589 1588 1983 1982 2345 2346 2674 2676 2973 3109 3359 3239 3577 3576 3674 3671 3763 3918 3917 3759 3757 3666 3566 3841 3754 3911 3836 3660 3751 3750 3749 3747 3746 3828 3744 3826 3742 3741 3438 3546 3321 3322 3196 2921 2772 2773 2617 2452 2278 2097 1908 1711 1506 1293 1072  843  606  361  108 
 213  462  703  936 1378 1377 1788 1789 1981 2166 2343 2510 2672 3108 2826 2972 3237 3238 3470 3471 3673 3573 3670 3761 3669 3668 3667 3665 3664 3459 3663 3753 3662 3561 3659 3658 3657 3656 3655 3745 3653 3743 3651 3649 3547 3648 3549 3548 3324 2923 2924 2922 2774 2453 2279 2098 1909 1712 1507 1294 1073  844  607  362  109 
 212  461  701  935 1160 1586 1587 1787 1980 2165 2164 2342 2673 2512 3107 2971 2970 3358 3357 3575 3574 3466 3572 3571 3570 3569 3568 3460 3567 3756 3564 3752 3455 3835 3562 3560 3558 3335 3557 3556 3654 3555 3650 3551 3550 3439 3440 3064 3197 3323 3065 2775 2619 2618 2280 2099 1910 1713 1508 1295 1074  845  608  363  110 
 211  460  700  702 1159 1376 1585 1786 1978 1979 2341 2671 2823 2968 2969 3106 3236 3356 3469 3353 3468 3351 3465 3464 3463 3462 3461 3345 3343 3457 3565 3563 3456 3661 3452 3559 3451 3450 3448 3447 3554 3652 3552 3443 3442 3072 3441 3198 3200 2926 3199 2927 2925 2454 2281 2100 1911 1714 1509 1296 1075  846  609  364  111 
 210  459  699  934 1158 1375 1584 1785 1977 2340 2509 2511 2824 2669 2967 3105 3235 3234 3232 3354 3467 3352 3350 3349 3348 3347 3223 3344 3458 3218 3340 3339 3454 3338 3453 3337 3336 3334 3449 2941 3445 3553 3328 2936 3444 3204 3206 3327 3074 3325 2620 2928 2776 2455 2282 2101 1912 1715 1510 1297 1076  847  610  365  112 
 209  458  932  933 1157 1374 1583 1784 1976 2163 2162 2339 2670 3104 2966 3103 3233 3231 3355 3230 3229 3228 3227 3226 3225 3224 3222 3346 3221 3220 3219 3342 3217 3216 3215 3214 3213 3081 3079 3210 3330 3331 3077 3208 3329 3202 3205 3326 3066 3067 2621 2780 2622 2456 2283 2102 1913 1716 1511 1298 1077  848  611  366  113 
 208  457  698  931 1156 1373 1783 1782 2160 1975 2338 2508 2507 2668 2822 2964 3102 3101 3100 3099 3098 3097 3096 3095 3094 3093 3092 3091 3090 3089 3088 3341 3086 3085 3084 3083 3082 3080 3212 3211 3332 2940 3446 2633 3075 2933 2935 3069 2929 2931 2930 2777 2459 2457 2284 2104 2103 1717 1512 1299 1078  849  612  367  114 
 207  456  697  930 1155 1372 1582 1781 1974 2161 2337 2506 2667 2821 2818 2965 2963 2962 2961 2960 2959 2958 2957 2956 2955 2954 2953 2952 2951 2950 2948 3087 2947 2946 2945 2944 2943 2942 2477 2639 3333 3078 3209 2634 2788 3203 3071 3201 2932 2116 2778 2623 2625 2624 2286 2106 1914 1915 1513 1300 1079  850  613  368  115 
 206  455  696  929 1154 1580 1581 2159 2158 2157 2336 2505 2666 2820 2819 2817 2816 2815 2814 2813 2812 2811 2810 2809 2808 2807 2806 2805 2804 2485 2803 2949 2799 2644 2798 2797 2796 2795 2794 2636 2638 3076 3207 2469 2472 2790 2785 2784 3070 3068 2782 2779 2783 2285 2460 2458 2105 1718 1514 1301 1080  851  614  369  116 
 205  454  695  928 1579 1371 1578 1778 1780 1973 2335 2504 2665 2664 2663 2662 2661 2660 2659 2658 2657 2656 2655 2654 2653 2652 2651 2650 2649 2802 2646 2648 2645 2800 2643 2642 2478 2641 2792 2121 2793 2791 2789 2468 2470 2120 2787 3073 2296 2465 2628 2781 2627 2626 2287 1916 1917 1719 1515 1302 1081  852  615  370  117 
 204  453  694  927 1370 1369 1368 1777 1779 2156 2334 2503 2502 2501 2500 2499 2498 2497 2496 2495 2494 2493 2492 2491 2490 2489 2487 2137 2315 2316 2647 2801 2483 2480 2131 2479 2640 2306 2474 2938 2637 2937 2473 2122 2635 2467 2632 2934 2466 2631 2464 2463 2461 2290 2288 2107 1918 1720 1516 1303 1082  853  616  371  118 
 203  452  693  926 1153 1152 1151 1367 1972 2155 2333 2332 2331 2330 2329 2328 2327 2326 2325 2324 2323 2322 2321 2320 2319 2139 2318 2488 2314 2486 2484 2311 2482 2310 2481 2309 2308 2305 2476 2124 2939 2475 1934 2297 2299 2298 2119 2117 2629 2786 2294 2292 2462 2111 2289 2108 1919 1721 1517 1304 1083  854  617  372  119 
 202  451  692  925 1150 1577 1366 1576 1971 1773 1970 2153 2151 1964 2150 2149 2148 2147 2146 2145 2144 2143 2142 2141 2140 2317 1951 2138 1948 2134 2313 2132 1946 2130 2129 2128 2307 2127 2304 2301 2302 2303 2300 1932 2471 2118 2630 1929 1734 2114 2295 1925 1924 2110 2109 1923 1920 1722 1518 1305 1084  855  618  373  120 
 201  450  691  924 1148 1149 1969 1776 1575 1968 2154 1965 2152 1963 1962 1767 1961 1960 1959 1958 1957 1557 1956 1954 1953 1952 1756 1950 2135 1751 2133 1749 1752 1750 1545 1944 1941 1542 2126 1940 1937 2123 1936 1935 1326 1534 1735 1931 2293 2115 1927 2291 2113 2112 1729 1921 1724 1723 1519 1306 1085  856  620  619  374 
 200  449  690  923 1365 1362 1573 1775 1774 1772 1966 1771 1770 1769 1565 1768 1766 1765 1764 1763 1762 1955 1761 1759 1758 1757 1552 1949 1753 2136 1947 2312 1945 1546 1748 1943 1745 1330 1938 1743 1742 1535 1740 1324 1325 1103 1736 1930 1532 1928 1732 1926 1730 1728 1727 1922 1726 1725 1520 1307 1086  857  375  121  122 
 199  448  689  922 1364 1147 1142 1360 1571 1967 1138 1358 1568 1567 1566 1564 1563 1562 1561 1560 1559 1760 1346 1556 1555 1554 1553 1754 1755 1550 1549 1548 1547 1334 1333 1746 1747 1541 1744 2125 1939 1741 1538 1536 1537 1933 1321 1531 1319 1733 1529 1731 1527 1526 1525 1524 1523 1522 1521 1308 1087  858  621  123  379 
 198  447  688  921 1574 1361 1144 1143    0  914 1359 1570 1356 1355 1354 1353 1132 1352 1350 1349 1128 1558 1127 1345 1344 1343 1342 1340 1551 1339 1338 1337 1336 1335  888 1942 1543 1332 1540 1331 1110 1105 1329 1106 1109 1739  641 1102 1100 1320 1098 1528 1317 1316 1315 1313 1312 1311 1310 1309 1088  377  125  376  124 
 197  446  687  920 1146 1363  915 1141 1572 1357 1139  911 1137 1136 1135 1134 1351  904  905 1130 1347 1348  900 1126 1123  896 1341 1122 1121 1120 1119  890  891 1117 1116 1544 1113 1111  647  883 1108  881  880 1322 1533  399  876 1738  875 1530  873 1318 1097 1096 1314 1095 1093 1092 1091 1090  860  622  382  126  624 
 196  445  686  919 1145  918  679  680 1140  916  912  186  909  674  908  907 1133 1131  903  902 1129  901  899  664 1125  663 1124  660  895  894  893  892 1118  651  886  887 1114 1112  885 1539  403 1327  646 1107 1323  640 1104 1737 1101  638  872 1099  870  869  868 1094  866  865  864  863  859  623  862  381  127 
 195  444  685  684  683  681  917  438  913  678 1569  434  910  180  431  672  906  670  669  668  667  666  422  665  898  662  661  659  658  415  657  656  412  889  653  652 1115  650  408  649  406  405  879  643  877  401  639  397  874  637  636  871  635  634  633  867  631  630  386  629 1089  378  131  626  128 
 194  443  442  441  440  682  436  437  677  676  182  432  675  179  429  428  671  427  426  425  424  423  421  420  897  419  167  418  416  164  414  413  654  655  411  409  154  648  407  151 1328  882  402  645  400  878  644  145  146  395  394  393  392  391  390  632  387  137  628  627  133  385  625  861  129 
 193  192  191  190  189  439  188  187  185  184  183  181  433  430  673  178  177  176  175  174  173  172  171  170  169  168  166  165  417  163  162  161  410  160  159  158  156  884  404  153  155  152  150  642  149  148  398  147  396  144  143  142  141  140  139  389  138  388  136  135  383  130  384  132  380 

