# This puzzle is solvable
9#o;erjio
 2 73 55 34 61 31 41 10 45 
37 32 24 39 49 11 68 38  1#elueshro 
13 19 50 72 29 70  9 43 17 
12 33 23 48 16 67 65  7 42 
47 30 46  6 75 20 71 35 36 
28  5 66 59 76 80 52  0 22 
51 57 53 56 60 21 27 44 18 
78 40 26 63 69  4 58 64  8 
74 15 62 14 79 77  3 54 25 

